###################################################
          #       #         #   #         #       #
# #####M### ### ### # # ##### # # ####### # # #####
# #   #     # #     # # #     #   #     # # #     #
# # # ####### ####### # # ########### # # # ##### #
# # #   #         # # # #   #   #   # # #     # # #
# # # # # ### ### # # # ### # # # # # ####### # # #
# # # # #   # #   # # #       #   #   #     #   # #
# # # ##### # ### # # ############# ### ### ##### #
# # #       #   # # #       #       #   # #   # # #
# ############# # # ####### ######### ### ### # # #
#               # #       #         #   #   #   # #
################# ##### ########### ### # # ##### #
#       #   #   # #     #       #   #   # #       #
# ##### # # ### # # ##### ##### # # # ######### # #
#     #   #     #   #     #   #   # # #   #   # # #
# ### ##### ####### # ##### ### ##### # # # # ### #
#   # #     #       # #         #   #   #   # #   #
# ### # ##### ####### ########### # ######### # # #
# #   # # #   #     #             #     # #   # # #
# # ### # # ### ### ################# # # # #######
# # #     #   # #         #         # #   # #     #
# # # ####### # ######### # ####### # ##### # ### #
# # # #       #   #     #   #         #     # #   #
### # # ######### # ######### ######### ##### # ###
#   # #   #   #   # #         # #       #     #   #
# ####### # # # ### # ####### # # ####### ####### #
#       # # #   #     #     #   # #       #   #   #
####### # # ### ####### ### ##### # ######### # # #
#       # # #   #   #   #   #     # #         # # #
# ##### # # ##### # # ### ### ##### # # ##### # ###
# #   # # #   #   #   #   #   #       # #   # #   #
# ### # # ### # #B##### ### ############# # ##### #
#   # # # # # # #     #   #       #       #   #   #
# # # # # # # # ##### ### ####### # ######### # # #
# # #   #   #   #       #   #   #   #     #   # # #
# # ####### ##### ##### ### # # ####### ### ### ###
# #       # #     #   #   #   #         #   #     #
# ####### # # ##### # ### ####### # ##### ### ### #
#       # # #     # #   #   #   # # #   # #   #   #
####### # # ##### ##### ### ### # ### # # ### # # #
# #     # #     # #   #   #     #     # #   # # # #
# # ##### ##### # # # # ####### ####### ### ### ###
# # #   #       #   # #     #   #     #   #   #   #
# # # ############### # # ### ####### # ##### ### #
#   #         # # #   # #             #     # #   #
# ######### # # # # ################# ### ### # # #
#     #     # # # #           #     # # #     # #G#
##### # ##### # # ########### # ### # # ####### # #
#       #       #             #   #             #  
###################################################